C 212,157,79
F 136,123,120

NO ./assets/textures/img_no.xpm
SO ./assets/textures/img_so.xpm
EA ./assets/textures/img_ea.xpm
WE ./assets/textures/img_we.xpm


   11111111111111111111111111111
   10000000001100000000000000001
   10110000011100000010000011111
11110000000000000000000010001
10110000011100000010000000001
10000000001100000111011110001
11110111111111011100000010001
11110111111111011101010010001
11000000110101011100000010001
10000000000000001100000010001
10000000000000001101010010001
11000000110101011111011110N01
11110111111101011111000000001
11111111111111111  1111111111