NO assets/textures/img_no.xpm
SO assets/textures/img_so.xpm
WE assets/textures/img_we.xpm
EA assets/textures/img_ea.xpm

F 220,100,0
C 225,30,0

        1111111111111111111111111
        1000000000110000000000001
        1011000001110000000000001
        1001000000000000000000001
111111111011000001110000000000001
100000000011000001110111111111111
10110111111111011100000010001
11110111111111011101010010001
11000000110101011100000010001
10000000000000001100000010011
10000000000000001101010010011
11000001110101011111011110N0111
1110111 1110101 1011110100001
11111111 1111111 111111111111