NO assets/textures/img_no.xpm
SO assets/textures/img_so.xpm
WE assets/textures/img_we.xpm
EA assets/textures/img_ea.xpm

F 220,100,1
C 225,30,0

        1111111111111111111111111
        1000000000110000000000001
        1011000001110000000000001
        1001000000000000000000001
111111111011000001110000000000001
100000000N00000000000000000011111
10110111111111011100000000001
11110111111111011101010000001
11000000110101011100000010001
10000000000000001100000010011
10000000000000001101010010011
1100000111010101111101111000111
1110111 1110101 1011110100001
1111111 1111111 1111111111111