C 200,255,255
F 136,123,55

NO assets/textures/debug.xpm
SO assets/textures/debug2.xpm
WE assets/textures/debug4.xpm
EA assets/textures/debug3.xpm

    1111111111111111111111111
    1000001100000000000000001
11111000011100000010000010001
100100N0000000000000000010001
10110000011100000010000010001
10000000001100000111011110001
11110111111111011100000010001
11110111111111011101010010001
11000000110101011100000010001
10000000000000001100000010001
10000000000000001101010010001
11111111111111111111111111111
